XXXXXXXXXXXXXXXXXXX
X========X========X
X=XX=XXX=X=XXX=XX=X
X=XX=XXX=X=XXX=XX=X
X=================X
X=XX=X=XXXXX=X=XX=X
X====X===X===X====X
XXXX=XXX=X=XXX=XXXX
XXXX=X=======X=XXXX
XXXX=X=XX=XX=X=XXXX
=======X===X=======
XXXX=X=XXXXX=X=XXXX
XXXX=X=======X=XXXX
XXXX=X=XXXXX=X=XXXX
X========X========X
X=XX=XXX=X=XXX=XX=X
X==X===========X==X
XX=X=X=XXXXX=X=X=XX
X====X===X===X====X
X=XXXXXX=X=XXXXXX=X
X=================X
XXXXXXXXXXXXXXXXXXX